1111111111111111111111
1000000000000000000001
9011110010110100111109
9018000000000000008109
1011100009999000011101
1018000011771100008101
1011000013456100001101
1000010011111100100001
1000010000000000100001
1000000000000000000001
1001111110000111111001
1001800000000000081001
1001011000000001101001
1001011001111001101001
1001000001881000001001
1001000000000000001001
1001000100000010001001
1001000101001010001001
9000000101991010000009
9000000001111000000009
1200110000000000110001
1111111111111111111111
--

